######
#0020#
#0000#
#0001#
######